0000000000000000000000000000000000000
0000000000000000000000000000000000000
0000000000000000000000000000000000000
0000000000000000000000000000000000000
0000000000000000000000000000000000000
0000000000000000000000000000000000000
0000000000000111110000000000000000000
0000000000000000000000000000000000000
0000000000020000000222200000000000009
1111111111110000000111111110000111111
