0000000000000000000000000000000000000
1110000001100011000000000000000000000
0000000001000010010020000000000000000
0002200001000010000210020202200000000
0001100001100010000101111111100000000
0000002221000010000100000000100000000
0000001111000010000100000000100000000
0000000001100011111100000000000000000
0000000000000010900000022000000000000
0000001111100010111111111111100000000
