0000000000000000000000000000000000000
0000000000000000000000000000000000000
0000000000000000000000000000000000000
0000000000000000000000000000000000000
0000001111111111111111111110000000000
0000000000000000000000000010000000000
0000100000000000000000000010000000000
0000100000000000000000000000000000000
0000100000000900000002000000200000000
1111100000000111110011101111111111111
