0000000000000000000000000000000000000
0000100001000020202020200200000000000
0000000000000111111111111100000000000
0000000000000100000000000100000000000
0000100000000100000000009100000000000
0000000000000100011111111100000000000
0001100000000100000000000100000000000
0000100000000102000000000000000000000
0000100000000111000202020000000000000
1111100000000100011111111100000000000
