0000001111111100000000000000000000000
0000000000000110000000000000000000000
0000000000000010000000000000000000000
0000000000000010000000000000000000000
0000000000000010000000000000000000000
0000000000000010000000000000000000000
0000000000000010000000000000000000000
0000000000000010000000000000000000000
0000000020009010000002200000000000000
1111111111111111111111111111111111111
