0000000000000000000000000000000000000
0000000000000000000000000000000000000
0000000000900000000000000000000000000
0000000000100000000000000000000000000
0000000000000100001000000000000000000
0000000000000000000000100000000000000
0000000000000000000000000000000000000
0000000000000000000000000100000000000
0000022202022020202020000000000000009
1111111111111111111111111111111111111
