0000000000000000000000000000000000000
0000000000000000000000000000000000000
0000000000000000000000000000000000000
0000000000000000000000000000000000000
0000000000000000000001000000010000000
0000000000000000100000000200000001000
0000000000010000000000000110000001000
0000001000000000000000000000000001000
0000000000000000000000000000000001009
1111000000000000000000000011111111111
