0000000000000000000000000000000000000
0000000000000000000000000000000000000
0000000000000000000000000110000000000
0000000000000000011110000000000000000
0000000000000000000000000000000000000
0000000000000100000000000000000000000
0000000000000100000000000000000000000
0000001111000000010000000000000000000
0000000000000000000000002222000000009
1111100000000011111111111111111111111
