0000000000000000000000000000000000000
0000000000000000000000000000000000000
0000000000000000000000000000000000000
0000000000000000000000000000000000000
0000000000000000000000000111000000000
0000000000000000000000000000000000000
0000000000000111110000000000000000000
0000000000000000000000010000000000000
0000000000020000000200010000222200009
1111111111110000000111111111111111111
